00000000000000000000000
01 0  x  0     xx     0
0  0  0  0     xx     0
0  0  0  0     xx     0
0  0  0  0            0
0  0  0  0            0
0  0  0  0            0
0  0  0  0            0
0  0  0  00000000000000
0  x  0  x       x   F0
00000000000000000000000