00000000000000000000000
01 0  x  0     xx    F0
0  0  0  0     xx     0
0  0  0000     xx     0
0  x  0  0            0
0  0000  0            0
0  0  0  0            0
0  0     0            0
0  0  0  00000000000xx0
0  x  0  x       x    0
00000000000000000000000