00000000000000
01 0         0
0  0  xx   0 0
0xx0  000    0
0    0   0 x 0
0   0 xx Fx0 0
00000000000000