00000000000000
01 0  xx     0
0  0  xx   0 0
0     xx   0F0
00000000000000