0000000000000000000000000
01 0  x  0  0  0  0  x  0
0  x  0000  x  0  x  0  0
0  0000  0  0  0  0000  0
0  x  0  0  0  0  x  0  0
0  0  0  x  0  0  0000  0
0  x0 x  0  0  0  0  x  0
0  0 00  0  0000  0  x  0
0  x  0  0  x  0  0  0000
0  0  x  0  0  0  0  x  0
0  x  0000  0  x  0  0  0
0  0  x  0  0  x  0  0 F0
0000000000000000000000000