00000000000000
01    xx     0
0     xx     0
0     xx    F0
00000000000000